ai	whom, who, anyone
anh	English, the United Kingdom, England
anh trai	older brother, elder brother
anh ấy	he, him
ba	third, father, dad
bao	bag
bay	flies, blown, fly
biết	knows, know, knowing
buồn	are sad, sorry, was sad
buổi	the, session
buổi sáng	morning
buổi tối	evening, night
bà	grandmother
bàn	the table, table, the desk
bác sĩ	doctor
bán	sell, sells
bánh	cake, cookie, pie
bánh mì	bread
báo	newspaper, journal, paper
bát	bowl
bây giờ	now, moment, it
bé gái	girl
bình thường	normal, usual
bò	ox, cow, bull
bơi	swim, swims, swimming
bướng bỉnh	stubborn
bạn	friends, you, friendship
bạn học	classmate
bảo thủ	conservative
bảo vệ	protect, protects
bảy	seven
bất cẩn	careless
bất lịch sự	impolite
bất lợi	disadvantage, disadvantageous
bật	turn on, on
bắc	north
bắt đầu	begin, start, starts
bằng	with, as, equals
bọn họ	they
bố	dad, father
bố mẹ	parents
bốn	four, 4
bồ đào nha	Portugal
bộ	(classifier for clothes), (classifier for sets), board
bởi vì	because
bữa	meals, meal
ca	mug, shift
ca sĩ	singer, singers
cam	orange
canh	soup
chai	bottle, bottles
chanh	lemon
chay	vegetarian, vegan
chia buồn	condole, condolence
chia sẻ	share
chim	bird
chim sẻ	sparrow
chiếc	the, ones
chiếc váy	skirt
chiếc áo	shirt
chiều	afternoon
cho	for, let, lets
cho phép	allow, allows, let
cho tôi hỏi	excuse me
chuyên nghiệp	professional
chuối	banana, bananas
chuồn chuồn	dragonfly
chuột	mouse
chào	greet, hello, greets
chào mừng	welcome
chào tạm biệt	bye, goodbye
châu	continent
chín	nine, 9
chó	dog
chú	uncle, you
chúc mừng	congratulate
chúc ngủ ngon	good night
chúng tôi	we, us
chơi	play, plays, playing
chạy	run, runs, running
chất lượng	quality, qualities
chậm	slow, slowly (when placed after verb), late
chị	sister, older sister, older sisters
chị gái	older sister
chồng	husband, husbands
chủ nhật	sunday
con	little, kid, child
con gái	daughter, girl
con trai	son, boy
cuối cùng	finally, last, final
cuốn	classifier of documents and stories, the, roll
cà chua	tomato, tomatoes
cà phê	coffee
cá	fish
cá sấu	alligator
các	(indicates plurality)
cái	the, a, (classifier)
câu	sentence
câu hỏi	question
câu trả lời	answer
cây tre	bamboo
có	is, there are, with
cô gái	the girl, girl, girls
cô ấy	she, her
công nhân	worker, workers, a worker
cùng	with, the same, together
căn nhà	house
cũ	are old, old, former
cũng	too, also, as well
cơm	rice
cười	smile, smile/smiles, laugh/laughs
cạnh tranh	compete, competing
cả	all, both, all over
cả tin	gullible, credulous
cảm ơn	thanks, thank you
cảnh sát	police, officers, officer
cần	need, require/requires (verb), need/needs (verb)
cần thiết	necessary
cẩn thận	be careful, look out, carefully
cậu bé	boy, The boy
cắn	bite
cố gắng	try, try (+ to infinitive), tries
cộng hoà séc	Czech Republic
cởi	take off
của	de, 's, of
cứ tự nhiên	help yourself
cửa hàng	store
cửa sổ	window, windows
diễn	show, perform, action
diễn viên	actor, actress
diễn viên hài	comedian
doanh nhân	businessman, entrepreneur, businesswoman
dài	long
dám	dare, dares
dê	goat
dì	aunt
dùng	use, using, uses
dũng cảm	brave, courageous
dơ	dirty
dơi	bat
dạo này bạn thế nào	what's up, how are you doing
dầu ăn	cooking oil
dễ	easy
dừng	stop, stops
em	you, younger brother, younger sister
em gái	younger sister
em trai	younger brother
ga	station, gas
ghi âm	record, records
ghét	hate, hates, hated
ghế	chair
gia đình	family
giao tiếp	communicate, communicating
giàu	rich
giày	shoes, shoe, the shoes
giáo viên	teacher
giây	second, seconds
giúp	help, helps
giường	bed
giấu	hide
giờ	hour, hours, now
giữ	keep
gà	chicken
gái	girl
gì	what, what are, what is
găng tay	glove
gương	mirror, example
gấu	bear
gặp	encountered, dealing, meeting
gặp lại sau	see you later
gọi	orders, call, order (food)
gửi	send, sends
hai	two
hay	well, in ... or, interesting
hay là	or
heo	pig
hiểu	understand, understood, understands
hiện tại	now, moment, currently
hiện đại	modern
hoàn hảo	perfect
hoặc	or, either...or
hy vọng	hope, hopes
hài hước	humorous, funny
hàn quốc	South Korea
hát	sing, sings, singing
hãy	let's, let, please
hè	summer
hôm nay	today
hôn	kiss
hôn nhân	marriage
hơn	more, than, more than
hướng	direction, heading
hạnh phúc	happiness, happy
hẹn gặp lại	see you later, see you again, see you
họ	they, they are, they're
họ hàng	relatives, relative
học	school, take lessons, to learn
học sinh	student
hỏi	ask, asks
hồng	pink
hỗ trợ	support, supports, supporting
hộ chiếu	passport
hợp tác	cooperate
khi	when, as, on
khi nào	when, when does, when are
khiêm tốn	humble, modest
khoai tây chiên	chips, French fries
khoác	coat, coats
khoẻ	well, strong, fine
khuyên	recommended, advises, advised
khách sạn	hotel, hotels
khó	hard, difficult
khóc	crying, cries, cry/cries
không	do not, no, weren't
không có gì	you're welcome
không phải	not, is not, are not
không phải là	not, wasn't, am not
khăn quàng	scarf, scarves
khẳng định	affirm
khỉ	monkey
kia	that, those, other
kiên nhẫn	patient
kiến trúc sư	architect
kế toán	accountant, accounting
kỹ sư	engineer
la bàn	compass
linh hoạt	flexible
luyện	practices, practice
luyện tập	practice
luật sư	lawyer
ly	cup, cups, glass
là	is, am, being
làm	to be, has worked as, do on
làm sao	how
làm việc	work, working, works
làm ơn	please
lúc này	now, this moment, right now
lăm	five (for 15 or higher), five
lười biếng	lazy
lượng mưa	precipitation, rainfall
lạc quan	optimistic
lấy	takes, take, get
lần	time, times, turns
lắng nghe	listen, listens, listening
lặp lại	repeat, repeats
lẻ	(used at hundred level)
lịch	calendar
lịch sự	polite
lớn	large, big, great
lợi thế	advantage, advantages
mang	is, wears, carrying
may mắn	lucky, luck
mua	buy
mua sắm	shop, shopping
muối	salt, salty
muốn	want
muỗng	spoon
mà còn	not only... but also, but also
màu	color
máy bay	airplane, plane
máy tính	computer
mây	cloud
mèo	cat
mì	noodles
mì ý	pasta
mì ăn liền	instant noodles
mình	I'm, I, herself
món	dish, kind, (indicates item of food)
mùa	season, crop
múa	dance, dances, dance/dances (verb)
mũ	hat
mươi	thirty
mười	ten
mẫu giáo	kindergarten
mặc	wear, wears
mẹ	mom
mọi người	everybody, everyone, people
mốt	one (for 21 or higher), vogue, one
mỗi	each, per, every
một	an, a, first
mới	new
mở	open, opens, turn on
nam	south, male, Nam
nam cực	antarctic
nay	this, now
nga	Russia
nghe	listen, hear/hears, listens
nghiêm túc	serious
nghèo	poor
nghìn	thousand, thousands, 1000
nghĩ	think, thinks
nghề nghiệp	profession, occupation
nghệ sĩ	artist
ngon	delicious, deliciously
ngoài	out, besides, aside
nguy hiểm	dangerous
ngày	day, date, st
ngày mai	tomorrow
ngày sinh	birthday, date of birth
ngân hàng	bank
ngã	fall
ngôi trường	school
ngôn ngữ	language
ngư dân	fisherman
người	people, (classifier for human), the
người mẫu	model, models
ngắn	short
ngồi	sit, sits, sitting
ngủ	sleep, slept, sleeps
ngựa	horse
nha sĩ	dentist, dentists
nhanh	fast, (can be adjective or adverb)
nhanh lên	hurry up
nhiêu	much
nhiều	lots, many, various
nhà báo	journalist
nhà ga	train station
nhà hàng	restaurant
nhà khoa học	scientist, scientists
nhà lãnh đạo	leader, leaders
nhà sư	monk
nhà thiết kế	designer
nhà toán học	mathematician
nhà vệ sinh	bathroom
nhìn	look
như	like, as
nhưng	but, however
nhạc sĩ	songwriter, songwriters
nhạt	light
nhảy	jump, dance, jumps
nhất	first, most, the most
nhận ra	realize
nhật	Japan
Nhật	Japan
nhỏ	small, little
những	these, my, the
nào	let's, any, what kind of
này	this, these, hey
nâu	brown
nên	ought, then, so
nó	he, it's, it
nói	spoken, speaks, to say
nóng	hot
nông dân	farmer
năm	years, 5, year
nước	water, country, countries
nước ép	juice
nấm	mushroom
nấu	to cook, cook, cooking
nấu ăn	cook, cooks, cooking
nặng	heavy
nếu	if
nổi	famous
nổi tiếng	famous, popular
nửa	half
ong	bee
phi	Phi (proper name)
phà	ferry
Pháp	French, France
phát hiện	discover
phát minh	invent, invention, invents
phân biệt	distinguish
phía sau	behind
phía trước	in front of, up ahead
phòng	room
phút	minute, minutes
phường	ward
phải không	is there ... ?, do ... ?, were ... ?
phở	pho, phở
phụ nữ	woman, women, female
phức tạp	complicated
pin	battery
quan trọng	is important, important, was important
quan tâm	care, considered, cares
quyển	the, (classifier)
quá	too, so, very
quả	(classifier), fruit
quần	pants, trousers
quốc gia	country, national (adj), nation
quốc tịch	nationality, citizenship
rau	vegetable, vegetables
rùa	turtle, tortoise
rượu	alcohol, wine
rất	extremely, very much, so
rắn	snake
rẻ	cheap
rồng	dragon
sai	wrong
sao	what, what do, why
sau	behind, next, then
sau khi	after
sinh viên	student, the students, students
siêng năng	hard-working, diligent
so sánh	compare
sách	book
sáng	morning, bright, light
sáu	six, sixth
sân bay	airport, airports
súp	soup
sản xuất	produce, producing, produces
sấm sét	thunder
sẽ	are going to, are going to be, will be
số	number
sống	alive, live, living
sở thú	zoo
sợi dây	string
sữa	milk
sự	(classifier)
sự bắt đầu	beginning
sự kiên nhẫn	patience
sự lịch sự	politeness
sự nghiêm túc	seriousness
sự nghiệp	career
sự phức tạp	complexity
sự thay đổi	change
sự thành công	success
sự thân thiện	friendliness
sự thật	truth
sự đơn giản	simplicity
sự đồng ý	agreement
sự ủng hộ	support
tai nạn	accident
tham lam	greedy
thay đổi	change, changes
thiên niên kỷ	millennium, millenniums
thoả mãn	satisfied, satisfy
thu	autumn, fall
thung lũng	valley
thuyền trưởng	captain
thuốc lá	tobacco
thuỵ sĩ	Switzerland
thành công	successful, succeed, success
tháng	months, month, months'
tháng một	january
tháng tư	april
thân thiện	friendly
thì	is, am, then
thích	like, likes
thông minh	smart, intelligent
thư	letter
thư ký	secretary
thảo luận	discuss, discusses, discussing
thất bại	fail, failure
thấy	see, find (limited context), sees
thập niên	decade
thật	real, so, really
thật không	really
thắng	win, defeat, wins
thắt lưng	belt
thế hệ	generation
thế kỷ	century
thế nào	how, how were, how was
thịt	meat
thỏ	rabbit, rabbits, bunny
thời gian	time
thủ đô	capital
thứ	things, th, thing
thứ tư	wednesday, fourth
thức ăn	food
thử	try, tries, try (sth) on
thử thách	challenge, challenges
thực đơn	menu
tin	believe, trust
tivi	television, televisions, tv
tiếng	hour, hours, classifier for languages
tiện lợi	convenient
trai	boy
triệu	million, millions
trong	inside, for, at
trong khi	while
Trung Quốc	China
trung thực	honest
truyền thống	traditional, tradition
trà	tea
trái	(classifier for fruits), the, left
trái cây	fruit
trâu	buffalo
trăm	hundred
trưa	noon
trước	ago, in front of, before
trước khi	before
trưởng thành	mature, adult
trạm	station, stations
trả lời	answer, respond, answers
trắng	white
trở lại	return, returns
trở thành	become, get, becoming
trở về	return, get back
trứng	egg
trừng phạt	punish
tuy	although, however, despite
tuần	week, weeks
tuổi	age
tàu hoả	train
tách	cup
tám	eight
táo	apple
tây	west, western
Tây Ban Nha	Spain, Spanish
tên	name, first name, title
tìm	looking for, find, look for
tìm hiểu	learn about, get to know, learn
tìm ra	find, finds, find out
tích cực	positive
tím	purple, violet
tính cách	characteristic, character, personality
tôi	I
tôn trọng	respect, respects
túi	bag
tư	private, four (for 24 or higher), four
tương lai	future
tại	at, in
tạm biệt	goodbye, bye
tạp chí	magazine
tất	socks
tập	practice
tập trung	concentrate, focus
tắm	takes a shower, bath, bathing
tắt	off, turn off, close
tặng	gifts, gift, gift (verb)
tệ	bad
tối	dark, evening, night
tối nay	tonight
tốt	well, fine, great
tồn tại	exist, exists, existing
tổng cộng	totally, in total
tờ	sheet
tờ giấy	paper
từ	word, since, from
từ điển	dictionary, dictionaries
tử tế	kind, gracious
tỷ	billion
uống	drink, has, drinks
viết	write, writes
việc	work, business, job
việt	Vietnamese
việt nam	Vietnam, Vietnamese
voi	elephant
vui lòng cho	please
và	and
vàng	yellow, gold
vào	to go into, for, into
váy	skirt
vâng	yes, (politely)
vé	ticket
vì	because, for, because of
ví	wallet, purse
văn hoá	culture
vĩnh viễn	forever
vẫn	yet, still
vẻ đẹp	beauty
vẽ	draw, draws, drawing
về	for, toward, about
vịt	duck
với	with, plus, at
vở	notebook
vợ	wife, spouse
vừa mới	just
xa xỉ	luxurious
xanh da trời	blue
xanh lá cây	green
xe buýt	bus
xe taxi	taxi, taxis, (a) taxi
xe ô tô	car
xe đạp	bike, bicycle
xem	watching, look at, watched
xin	beg, ask for, please
xin chào	hello, hi
xin lỗi	apologize, sorry, excuse me
xuân	spring
xuất bản	publish, publishing
xám	gray, grey
xấu tính	mean
xứng đáng	deserve
y tá	nurse
yêu	love, loves, loving
á	Asian
áo	shirt
áo lạnh	sweater
âu	Europe
ích kỷ	selfish
ít	little, few, some
ô	umbrella
ôm	hug
ông	grandfather
úc	Australia, australian
ăn	eats, ate, eating
đam mê	passion
đang	is, am, (action is taking place)
đen	black
đi	travel, wear (refers to shoes), to go
đi du lịch	travelling, traveling, travel
đi nào	let's go
điện thoại	phone, telephone
đom đóm	firefly
đu quay	ferris wheel
đu đủ	papaya
đàn ông	men, man
đá	ice
đánh giá cao	appreciate
đáp án	answer
đâu	where, where is ... ?, which
đây	this, is here, these
đèn	light, lamp
đó	that, those, there
đói	hungry
đô	dollar
đôi	two, pair of, pairs
đông	winter, East, crowded
đúng	right
đĩa	dish, plate
đơn giản	simple
đưa	handing, handed, take
đường	sugar
đại dương	ocean
đảo	island
đầm	dress
đầu bếp	cook
đầu tiên	first
đậm	dark, deep
đắt	expensive
đắt tiền	expensive
đặc biệt	special, especially
đặt chỗ	make a reservation, reservation
đẹp	beautiful, pretty
đến	is, arrives, go
đến từ	are from, comes from, come from
đều	both of, all, both
để	for, let, lets
địa hình	terrain
đọc	read, reads
đỏ	red
đối mặt	face
đồng	VND, dong, bronze
đồng bằng	plain
đồng hồ	watch, clock
đồng ý	agree, agrees
độc lập	independent, independence
đội	wears, the team, team
động vật	animals, animal
đỡ	help
đợi	wait
đủ	enough
đứa con	child, children, baby
đứa trẻ	kid, child
Đức	Germany
đứng	stand, stands, stand/stands
đừng	do not, don't, not
ư	(untranslated)
ấn độ	India
ổn	fine
ớt	chili, peppers, chilli
ở	stayed, stayed in, has stayed in
ở đâu	where, where does ... ?, where is ... ?
ủng	boots
ủng hộ	supports, support